111111111111111
1P1111000000E11
1ccc11111100001
100011111100001
100000000000001
111111111111111
