11111111111111111
1P11111E000000001
10000111111111101
11110111111100001
1111c111111001111
11100111111c11111
11101111111011111
111c0011111011111
11111000c00011111
11111111111111111
