1111111111
1c000ooo1
10c0000001
11111000001
11111111111
