1111111111111111111111111111111111111111
10000P0000011111111111100000000000E11111
100000000100000c111111000001000000011111
1000c00010000011111110000000100000011111
1000000000000011111100000000011111111111
1111111111111011111100000010001111111111
111111000010000000c1111111111c1111111111
1111110000000000000111111111101111111111
1111110001000000000c1111111110c000011111
1111110000001001000111111111111111011111
1111110101000000000111111111111111011111
1111111000000010010111111111111111011111
1111110010000000100111111111111111011111
1111110000c0000000c111111111111111011111
1111110111111111111111111111110000011111
1111110111111111111111111111100111111111
1111110111111111111111111111101111111111
1111110011111111111c11111111101111111111
111111100000000000000000000000c111111111
1111111111111111111111111111111111111111
